31 21
40 735
15 6 6 0 0 12 12 12 0 0 0 0 0 15 0 0 11 0 0 6 6 6 6 6 0 0 11 11 0 0 20
6 1 1 1 1 1 1 1 1 11 1 1 7 8 1 1 1 1 1 11 0 1 1 1 1 1 1 1 1 1 0
0 1 1 1 1 1 1 1 1 0 1 1 9 10 1 1 1 1 1 0 11 1 1 1 1 1 1 1 1 1 6
0 7 8 7 8 7 8 1 1 11 1 1 0 0 1 1 6 1 1 11 0 1 1 0 0 0 2 3 1 1 6
0 9 10 9 10 9 10 1 1 0 1 1 7 8 1 1 6 1 1 0 11 1 1 2 3 0 4 5 1 1 6
20 1 1 1 1 1 1 1 1 11 1 1 9 10 1 1 6 1 1 11 0 1 1 4 5 0 0 0 1 1 6
20 1 1 1 1 1 1 1 1 0 1 1 1 1 1 1 0 1 1 1 1 1 1 1 1 0 16 17 1 1 0
20 1 1 2 3 2 3 2 3 0 1 1 1 1 1 1 12 1 1 1 1 1 1 1 1 0 18 19 1 1 11
20 1 1 4 5 4 5 4 5 15 1 1 6 6 1 1 12 12 12 12 12 12 12 1 1 20 1 1 1 1 11
0 1 1 1 1 1 1 1 1 1 1 1 6 0 7 8 7 8 7 8 7 8 12 1 1 20 1 1 1 1 0
0 1 1 1 1 1 1 1 1 1 1 1 6 0 9 10 9 10 9 10 9 10 12 1 1 20 2 3 1 1 20
7 8 7 8 7 8 7 8 7 8 1 1 6 0 1 1 1 1 1 1 7 8 0 1 1 0 4 5 1 1 20
9 10 9 10 9 10 9 10 9 10 1 1 6 0 1 1 1 1 1 1 9 10 0 1 1 11 2 3 1 1 20
0 1 1 1 1 1 1 1 1 1 1 1 0 0 1 1 15 0 1 1 7 8 0 1 1 0 4 5 1 1 0
11 1 1 1 1 1 1 1 1 1 1 1 0 0 1 1 0 20 1 1 9 10 0 0 0 11 2 3 1 1 20
0 1 1 2 3 2 3 2 3 2 3 2 3 0 1 1 20 20 1 1 7 8 7 8 7 8 4 5 1 1 0
11 1 1 4 5 4 5 4 5 4 5 4 5 0 1 1 20 20 1 1 9 10 9 10 9 10 2 3 1 1 12
0 1 1 1 1 1 1 1 1 1 1 1 1 1 1 1 20 20 1 1 1 1 1 1 1 11 4 5 1 1 12
15 1 1 1 1 1 1 1 1 1 1 1 1 1 1 1 20 20 1 1 1 1 1 1 1 0 2 3 1 1 12
0 1 1 12 12 12 12 0 6 6 6 6 6 0 0 20 20 20 20 20 20 0 0 0 0 0 4 5 1 1 12
12 12 0 6 6 11 11 11 0 0 12 12 12 6 6 6 6 15 11 11 11 11 6 6 6 6 0 0 0 12 12
