31 21
40 735
22 22 23 23 23 22 22 23 23 24 24 24 24 24 22 22 23 23 24 24 22 22 24 24 24 24 23 23 23 22 60
22 21 21 21 21 21 21 21 21 23 21 21 41 42 21 21 21 21 21 23 22 21 21 21 21 21 21 21 21 21 22
22 21 21 21 21 21 21 21 21 23 21 21 43 44 21 21 21 21 21 22 23 21 21 21 21 21 21 21 21 21 62
23 41 42 33 34 41 42 21 21 23 21 21 24 24 21 21 24 21 21 23 22 21 21 60 60 24 25 26 21 21 62
23 43 44 35 36 43 44 21 21 23 21 21 33 34 21 21 24 21 21 22 23 21 21 25 26 24 27 28 21 21 62
61 21 21 21 21 21 21 21 21 22 21 21 35 36 21 21 24 21 21 23 22 21 21 27 28 22 45 46 21 21 62
61 21 21 21 21 21 21 21 21 22 21 21 21 21 21 21 22 21 21 21 21 21 21 21 21 22 47 48 21 21 22
61 21 21 29 30 33 34 29 30 22 21 21 21 21 21 21 62 21 21 21 21 21 21 21 21 22 49 50 21 21 61
22 21 21 31 32 35 36 31 32 22 21 21 60 60 21 21 62 62 62 62 22 22 22 21 21 61 21 21 21 21 61
22 21 21 21 21 21 21 21 21 21 21 21 25 26 33 34 25 26 33 34 25 26 23 21 21 61 21 21 21 21 61
60 21 21 21 21 21 21 21 21 21 21 21 27 28 35 36 27 28 35 36 27 28 23 21 21 61 37 38 21 21 61
41 42 33 34 41 42 33 34 41 42 21 21 24 22 21 21 21 21 21 21 37 38 22 21 21 23 39 40 21 21 22
43 44 35 36 43 44 35 36 43 44 21 21 22 24 21 21 21 21 21 21 39 40 22 21 21 23 33 34 21 21 24
23 21 21 21 21 21 21 21 21 21 21 21 24 22 21 21 60 60 21 21 61 61 61 21 21 23 35 36 21 21 22
23 21 21 21 21 21 21 21 21 21 21 21 22 24 21 21 62 62 21 21 62 51 52 53 22 23 37 38 21 21 24
62 21 21 25 26 33 34 25 26 33 34 25 26 62 21 21 62 62 21 21 62 54 55 56 22 22 39 40 21 21 24
62 21 21 27 28 35 36 27 28 35 36 27 28 62 21 21 22 24 21 21 22 57 58 59 22 22 33 34 21 21 22
22 21 21 21 21 21 21 21 21 21 21 21 21 21 21 21 22 22 21 21 21 21 21 21 21 62 35 36 21 21 60
22 21 21 21 21 21 21 21 21 21 21 21 21 21 21 21 62 62 21 21 21 21 21 21 21 23 37 38 21 21 60
62 21 21 62 62 60 60 60 61 61 61 22 22 22 23 37 38 23 24 24 37 38 62 62 62 62 39 40 21 21 60
62 62 62 62 24 24 24 22 22 22 61 61 61 61 22 39 40 23 23 22 39 40 22 22 24 24 22 23 21 21 22